typ:MAP
WWWWWWWWWWWWWW
WFFFFFFFFFFFFW
WFFFFFFFFFFFFW
WFFFFFFPFFFFFW
WFFFFFFFFFFFFW
WFFFFFFFFFFFFW
WFFFFFFFFFFFFW
WFFFFFFFFFFFFW
WFFFFFFFFFFFFW
WFFFFFFFFFFFFW
WFFFFFFFFFFFFW
WFFFFFFFFFFFFW
WFFFFFFFFFFFFW
WFFFFFFFFFFFFW
WFFFFFFFFFFFFW
WFFFFFFFFFFFFW
WFFFFFFFFFFFFW
WFFFFFFFFFFFFW
WFFFFFFFFFFFFW
WWWWWWWWWWWWWW
